pums	household
DIVISION	DIVISION
ST	REPORTABLE_DOMAIN
ELEP	DOLLAREL
GASP	DOLLARNG
FULP	DOLLARLP
YBL	YEARMADE
MV	OCCUPYYRANGE
HINCP	MONEYPY
TEN	KOWNRENT
NP	NHSLDMEM
BLD	TYPEHUQ
BDSP	BEDROOMS
RMSP	TOTROOMS
FS	FOODASST
ACCESS	INTERNET
MODEM	INCABLE
SATELLITE	INSATEL
DIALUP	INDIALUP
DSL	INDSL
HFL	FUELHEAT
LAPTOP	NUMPC
REFR	NUMFRIG
STOV	STOVEN
FES	EMPLOYHH
HISP	SDESCENT
RAC1P	Householder_Race
AGEP	HHAGE
SCHL	EDUCATION
INTP	INVESTMT
WAGP	WORKPAY
RETP	RETIREPY
SSIP	SSINCOME
POVPIP	POVERTY100